WWWWWWWW
WWWWWWWW
WWGGGWWW
WGGGGGWW
WWWGWWWW
WGWWWWWW
GGGWWWWW
WWWWWWWW